F 220,100,0
C 225,30,0
NO ./textures/path_to_the_north_texture.xpm
EA ./textures/path_to_the_east_texture.xpm
SO ./textures/path_to_the_south_texture.xpm
WE ./textures/path_to_the_west_texture.xpm

1111111111
10000000011
1000N1001
1000000001
111111111
