NO ./textures/prison.xpm
SO ./textures/prison.xpm
WE ./textures/prison.xpm
EA ./textures/prison.xpm
DO ./textures/door.xpm

F 220,100,0
C 225,30,0

        11111111111 11111111111111
        10000000001 10000000000001
        10000000001 10000000000001
        10000000001 10000000000001
1111111110000000001 10000000000001
100000000000000000111111D111111111
10000000000000000000000000001
10000000000000000000000000001
11000000000000000000000000001
10000000000000000111001D11111
1111D111000000011100000000001
1100000111000001 100000000N01
10000001 1000001 100000000001
11111111 1111111 111111111111