1111111111
1010000001
1001000001
10000W0001
1100000001
1111111111