1111111
1010001
1001001
10000N1
1111111